101010000011100
100000111111101
111000000G10000
M00011111011110
110001110000000
111000000111111
000011111101100
111000001000001
110001111000110
001011100000000
000001111111000
111000000000000
111011110001100
000000000011111
011111000000111