1010100000
1000001111
111000000G
M000111110
1100011100
1110000001
0000111111
